P;X;X;X;R;H;X;X;X;X
X;X;X;X;R;X;X;X;X;X
X;X;X;X;R;X;X;X;X;X
X;X;X;X;R;X;X;X;X;X
X;X;X;X;R;X;X;X;X;X
X;X;X;X;X;X;X;G;X;X
X;X;X;X;X;X;X;X;X;X
X;X;X;X;X;X;X;X;X;X