X;X;X;X;X;X;X;X;X;X;X;X;X
X;X;X;X;X;X;X;X;X;X;X;X;X
G;X;X;X;X;X;X;X;X;X;X;X;X
X;X;X;X;X;X;X;X;X;X;X;X;X
X;X;X;X;X;X;X;X;X;P;X;X;X
X;X;X;X;X;X;X;X;X;X;X;X;X
X;U;U;U;U;U;U;U;U;U;U;U;U
X;X;X;X;X;X;X;X;X;X;X;X;X,H